1111111111111111111111111
1P00000000000000000000001
1C0000000000000000000C001
1000000000000000000000001
100000000000000000000E001
1000000000000000000000001
10000000000000000000N0001
1000000000000000000000001
1000000000000000000000001
1111111111111111111111111