1111111111111111111111111
1000000C0N00000000N000001
1C00000000000000N0000C001
1000000000000000000000001
100000000000000000000E001
1000000N00000000000000001
100000000000000000N000001
1000N00000000000000C0N001
1P000000000C0000000000001
1111111111111111111111111
