1111111111111
10010N00000C1
100000C111001
1P0011E000001
1111111111111