1111111111111111111111111
100000000N00000000N000001
1C0000000000000000000C001
1000000000000000000000001
100000000000000000000E001
1000000N00000000000000001
100000000000000000N000001
1000N0000000000000000N001
1000000000000000000000001
1111111111111111111111111
