1111111111111111111111111111111111111111
1P00000000000000000000000000000000000001
1111111100000000000000C00000001000000001
1000000000000000000000000000001000000001
1000000000000000000000000000001000000001
1000000000111100000000000000001000000001
100000000000C000000000000000001C00000001
1000000000000000000000000000001111110001
1000000000000000000000000000000000010001
1000000000000000000000000000000000010001
1000000000000000001111110000000000010001
100000000000000000000C000000000000010001
1000000111111100000000000000000000000001
100000000000C100000000000000000000000001
1000000000000100000000000000000000000001
1000000000000100000000000000000000000001
1000000000000100000000000111110000000001
10000000000000000000000001C0000000000001
1000000000000000000000001111111100000011
10000000000000000000000001E0000000000001
1111111111111111111111111111111111111111
